##########
@........#
########.#
#........#
#.########
#........#
########.#
#........#
#.########
#........#