##########
#........#
##......##
###....###
####..####
####@.####
###....###
##......##
#........#
##########