##..@.###
#......##
##.#.#..#
.........
#.###.##.
.........
##..##..#
#...##.##
..#.....#
.###...##